1111111111111111111
1000000000000000001
100N000000000100001
1000000000000000001
1000000000100000001
1000000000000000001
1111111111111111111
